alias ll="ls -l"
alias la="ls -la"
alias brew-update="brew update && brew upgrade"
alias brew-reinstall="/usr/bin/ruby -e \"\$(curl -fsSL https\://raw.githubusercontent.com/Homebrew/install/master/install)\""

alias original-py="pyenv global system;pyenv versions"
alias anaconda2="pyenv global anaconda2-5.0.1;pyenv versions"
alias anaconda3="pyenv global anaconda3-5.0.1;pyenv versions"
alias py2714="pyenv global 2.7.14;pyenv versions"
alias ansible2="pyenv global ansible2;pyenv versions"
alias espressif="pyenv global espressif;pyenv versions"

alias anaconda-update="anaconda2 && conda update conda -y && conda update anaconda -y && anaconda3 && conda update conda -y && conda update anaconda -y && original-py"
alias py2714-update="py2714 && pip install --upgrade pip && original-py"
alias ansible-update="ansible2 && pip install --upgrade pip && sudo pip install --upgrade ansible && original-py"
alias esptool-update="espressif && pip install --upgrade pip && sudo pip install --upgrade esptool && original-py"

alias notebook="anaconda3 && jupyter notebook"

alias Annie="ssh pi@Annie.local"
alias Bobby="ssh pi@Bobby.local"
alias Cathy="ssh pi@Cathy.local"
alias Dick="ssh pi@Dick.local"
alias Elsa="ssh pi@Elsa.local"
alias Fred="ssh pi@Fred.local"
alias Grace="ssh pi@Grace.local"
alias Harry="ssh pi@Harry.local"
alias Iris="ssh pi@Iris.local"
alias John="ssh pi@John.local"
alias Kate="ssh pi@Kate.local"
alias Leon="ssh pi@Leon.local"
alias Maggie="ssh pi@Maggie.local"
alias Wanda="ssh pi@Wanda.local"
alias Xan="ssh pi@Xan.local"
alias Yolanda="ssh pi@Yolanda.local"
alias Zero="ssh pi@Zero.local"
alias Susie="ssh linaro@Susie.local"
alias Tinker="ssh linaro@Tinker.local"
